6 6 6 6 6 6 6 6 6 6 6 6
6 3 3 3 3 3 3 3 3 3 3 6
6 3 6 6 6 6 6 6 6 6 3 6
6 3 6 3 3 3 3 3 3 6 3 6
6 3 6 3 6 6 6 6 3 6 3 6
6 3 6 3 6 6 6 6 3 6 3 6
6 3 3 3 6 6 6 6 3 6 3 6
6 1 1 1 6 6 7 6 3 6 3 6
6 1 2 1 6 6 3 3 3 6 3 6
6 6 3 6 6 6 6 6 6 6 3 6
6 6 3 3 3 3 3 3 3 3 3 6
6 6 6 6 6 6 6 6 6 6 6 6