1 1 1 3 3 3 1 1 1 1 1 1
3 3 3 3 6 3 1 3 3 1 3 1
3 1 3 6 6 6 3 3 3 1 3 1
3 1 3 3 3 3 3 1 3 3 3 3
3 1 1 3 1 1 1 1 1 1 1 3
3 1 1 3 3 3 6 3 2 1 1 3
3 1 1 1 1 3 3 3 1 1 1 3
3 1 1 1 1 1 1 1 1 1 1 3
3 3 2 1 1 1 1 1 3 6 3 3
1 1 3 1 1 1 1 1 3 6 3 1
1 1 3 3 3 3 3 3 3 3 3 1
1 1 1 1 1 1 1 1 1 1 1 1