3 3 3 3 3 3 3 3 3 1 4 4
3 1 1 1 3 1 1 1 3 1 4 4
3 1 3 1 3 3 3 1 3 1 1 1
3 1 3 1 1 1 3 3 3 3 3 1
3 1 3 3 3 1 1 1 1 1 3 1
3 1 1 1 3 3 3 3 2 1 3 1
3 3 3 1 1 1 3 1 1 1 3 2
1 1 3 1 3 1 3 1 3 1 3 1
3 3 3 1 3 3 3 1 3 1 3 3
3 1 1 1 3 1 1 1 3 1 1 3
3 3 3 3 3 1 4 1 3 3 3 3
1 1 1 1 1 1 4 1 1 1 1 1