1 1 1 1 1 1 1 1 1 1 1 1
1 1 1 1 1 1 1 1 1 1 1 1
1 1 1 1 1 1 1 1 1 1 1 1
1 1 1 1 1 1 1 1 1 1 1 1
1 1 1 1 1 1 2 1 1 1 1 1
8 5 5 0 0 0 0 0 0 0 0 5
0 5 0 0 5 0 0 0 0 5 0 0
0 0 5 0 0 0 0 0 5 0 0 0
0 0 0 0 0 0 5 0 0 0 5 0
5 0 5 0 0 0 0 0 0 0 0 0
4 4 4 4 4 4 4 4 4 4 4 4
4 4 4 4 4 4 4 4 4 4 4 4